130 44 132 104 77 23 133 63 122 35 83 125
130 86 19 123 95 48 61 43 89 20 40 91
130 112 131 18 46 65 6 119 54 14 129 13
130 124 32 45 70 10 85 115 94 26 42 117
130 62 7 116 17 126 105 88 92 96 80 100
130 97 34 56 114 60 81 121 102 12 5 2
130 75 22 15 72 106 29 66 76 128 71 11
130 59 120 50 53 4 82 33 1 113 79 73
130 30 58 39 111 51 99 109 67 87 3 9
130 8 64 31 74 21 24 118 107 27 101 37
130 36 84 38 55 52 28 93 16 57 110 103
41 44 84 31 111 4 29 121 92 26 129 91
41 86 132 38 74 51 82 66 102 96 42 13
41 112 19 104 55 21 99 33 76 12 80 117
41 124 131 123 77 52 24 109 1 128 5 100
41 62 32 18 95 23 28 118 67 113 71 2
41 97 7 45 46 48 133 93 107 87 79 11
41 75 34 116 70 65 61 63 16 27 3 73
41 59 22 56 17 10 6 43 122 57 101 9
41 30 120 15 114 126 85 119 89 35 110 37
41 8 58 50 72 60 105 115 54 20 83 103
41 36 64 39 53 106 81 88 94 14 40 125
49 44 64 50 114 10 61 93 67 128 80 13
49 86 84 39 72 126 6 63 107 113 5 117
49 112 132 31 53 60 85 43 16 87 71 100
49 124 19 38 111 106 105 119 122 27 79 2
49 62 131 104 74 4 81 115 89 57 3 11
49 97 32 123 55 51 29 88 54 35 101 73
49 75 7 18 77 21 82 121 94 20 110 9
49 59 34 45 95 52 99 66 92 14 83 37
49 30 22 116 46 23 24 33 102 26 40 103
49 8 120 56 70 48 28 109 76 96 129 125
49 36 58 15 17 65 133 118 1 12 42 91
47 44 58 56 46 52 82 88 89 27 71 117
47 86 64 15 70 23 99 121 54 57 79 100
47 112 84 50 17 48 24 66 94 35 3 2
47 124 132 39 114 65 28 33 92 20 101 11
47 62 19 31 72 10 133 109 102 14 110 73
47 97 131 38 53 126 61 118 76 26 83 9
47 75 32 104 111 60 6 93 1 96 40 37
47 59 7 123 74 106 85 63 67 12 129 103
47 30 34 18 55 4 105 43 107 128 42 125
47 8 22 45 77 51 81 119 16 113 80 91
47 36 120 116 95 21 29 115 122 87 5 13
25 44 120 45 55 106 6 118 102 20 3 100
25 86 58 116 77 4 85 93 76 14 101 2
25 112 64 56 95 51 105 63 1 26 110 11
25 124 84 15 46 21 81 43 67 96 83 73
25 62 132 50 70 52 29 119 107 12 40 9
25 97 19 39 17 23 82 115 16 128 129 37
25 75 131 31 114 48 99 88 122 113 42 103
25 59 32 38 72 65 24 121 89 87 80 125
25 30 7 104 53 10 28 66 54 27 5 91
25 8 34 123 111 126 133 33 94 57 71 13
25 36 22 18 74 60 61 109 92 35 79 117
78 44 22 123 53 65 99 115 107 96 110 2
78 86 120 18 111 10 24 88 16 12 83 11
78 112 58 45 74 126 28 121 122 128 40 73
78 124 64 116 55 60 133 66 89 113 129 9
78 62 84 56 77 106 61 33 54 87 42 37
78 97 132 15 95 4 6 109 94 27 80 103
78 75 19 50 46 51 85 118 92 57 5 125
78 59 131 39 70 21 105 93 102 35 71 91
78 30 32 31 17 52 81 63 76 20 79 13
78 8 7 38 114 23 29 43 1 14 3 117
78 36 34 104 72 48 82 119 67 26 101 100
127 44 34 38 17 21 85 109 54 113 40 11
127 86 22 104 114 52 105 118 94 87 129 73
127 112 120 123 72 23 81 93 92 27 42 9
127 124 58 18 53 48 29 63 102 57 80 37
127 62 64 45 111 65 82 43 76 35 5 103
127 97 84 116 74 10 99 119 1 20 71 125
127 75 132 56 55 126 24 115 67 14 79 91
127 59 19 15 77 60 28 88 107 26 3 13
127 30 131 50 95 106 133 121 16 96 101 117
127 8 32 39 46 4 61 66 122 12 110 100
127 36 7 31 70 51 6 33 89 128 83 2
98 44 7 39 95 60 24 119 76 57 42 73
98 86 34 31 46 106 28 115 1 35 80 9
98 112 22 38 70 4 133 88 67 20 5 37
98 124 120 104 17 51 61 121 107 14 71 103
98 62 58 123 114 21 6 66 16 26 79 125
98 97 64 18 72 52 85 33 122 96 3 91
98 75 84 45 53 23 105 109 89 12 101 13
98 59 132 116 111 48 81 118 54 128 110 117
98 30 19 56 74 65 29 93 94 113 83 100
98 8 131 15 55 10 82 63 92 87 40 2
98 36 32 50 77 126 99 43 102 27 129 11
69 44 32 15 74 48 105 33 16 14 5 9
69 86 7 50 55 65 81 109 122 26 71 37
69 112 34 39 77 10 29 118 89 96 79 103
69 124 22 31 95 126 82 93 54 12 3 125
69 62 120 38 46 60 99 63 94 128 101 91
69 97 58 104 70 106 24 43 92 113 110 13
69 75 64 123 17 4 28 119 102 87 83 117
69 59 84 18 114 51 133 115 76 27 40 100
69 30 132 45 72 21 61 88 1 57 129 2
69 8 19 116 53 52 6 121 67 35 42 11
69 36 131 56 111 23 85 66 107 20 80 73
108 44 131 116 72 51 28 43 94 12 79 37
108 86 32 56 53 21 133 119 92 128 3 103
108 112 7 15 111 52 61 115 102 113 101 125
108 124 34 50 74 23 6 88 76 87 110 91
108 62 22 39 55 48 85 121 1 27 83 13
108 97 120 31 77 65 105 66 67 57 40 117
108 75 58 38 95 10 81 33 107 35 129 100
108 59 64 104 46 126 29 109 16 20 42 2
108 30 84 123 70 60 82 118 122 14 80 11
108 8 132 18 17 106 99 93 89 26 5 73
108 36 19 45 114 4 24 63 54 96 71 9
68 44 19 18 70 126 81 66 1 87 101 103
68 86 131 45 17 60 29 33 67 27 110 125
68 112 32 116 114 106 82 109 107 57 83 91
68 124 7 56 72 4 99 118 16 35 40 13
68 62 34 15 53 51 24 93 122 20 129 117
68 97 22 50 111 21 28 63 89 14 42 100
68 75 120 39 74 52 133 43 54 26 80 2
68 59 58 31 55 23 61 119 94 96 5 11
68 30 64 38 77 48 6 115 92 12 71 73
68 8 84 104 95 65 85 88 102 128 79 9
68 36 132 123 46 10 105 121 76 113 3 37
130 41 49 47 25 78 127 98 69 108 68 90
44 86 112 124 62 97 75 59 30 8 36 90
132 19 131 32 7 34 22 120 58 64 84 90
104 18 116 15 39 38 123 45 56 50 31 90
77 70 72 74 95 17 53 55 46 114 111 90
23 126 51 48 60 21 65 106 52 10 4 90
133 81 28 105 24 85 99 6 82 61 29 90
63 66 43 33 119 109 115 118 88 93 121 90
122 1 94 16 76 54 107 102 89 67 92 90
35 87 12 14 57 113 96 20 27 128 26 90
83 101 79 5 42 40 110 3 71 80 129 90
125 103 37 9 73 11 2 100 117 13 91 90
