21 37 27 11 54 49 43 29
21 1 14 32 16 56 28 34
21 13 15 23 36 35 30 24
21 12 6 2 46 45 44 38
21 33 25 8 17 51 55 26
21 31 10 3 4 9 7 42
21 19 18 41 39 47 20 52
5 37 18 3 17 45 30 34
5 1 27 41 4 51 44 24
5 13 14 11 39 9 55 38
5 12 15 32 54 47 7 26
5 33 6 23 16 49 20 42
5 31 25 2 36 56 43 52
5 19 10 8 46 35 28 29
22 37 10 2 16 47 55 24
22 1 18 8 36 49 7 38
22 13 27 3 46 56 20 26
22 12 14 41 17 35 43 42
22 33 15 11 4 45 28 52
22 31 6 32 39 51 30 29
22 19 25 23 54 9 44 34
48 37 25 32 4 35 20 38
48 1 10 23 39 45 43 26
48 13 18 2 54 51 28 42
48 12 27 8 16 9 30 52
48 33 14 3 36 47 44 29
48 31 15 41 46 49 55 34
48 19 6 11 17 56 7 24
57 37 6 41 36 9 28 26
57 1 25 11 46 47 30 42
57 13 10 32 17 49 44 52
57 12 18 23 4 56 55 29
57 33 27 2 39 35 7 34
57 31 14 8 54 45 20 24
57 19 15 3 16 51 43 38
50 37 15 8 39 56 44 42
50 1 6 3 54 35 55 52
50 13 25 41 16 45 7 29
50 12 10 11 36 51 20 34
50 33 18 32 46 9 43 24
50 31 27 23 17 47 28 38
50 19 14 2 4 49 30 26
40 37 14 23 46 51 7 52
40 1 15 2 17 9 20 29
40 13 6 8 4 47 43 34
40 12 25 3 39 49 28 24
40 33 10 41 54 56 30 38
40 31 18 11 16 35 44 26
40 19 27 32 36 45 55 42
21 5 22 48 57 50 40 53
37 1 13 12 33 31 19 53
27 14 15 6 25 10 18 53
11 23 8 41 32 2 3 53
54 46 39 36 4 16 17 53
49 51 56 9 35 47 45 53
43 7 44 28 20 55 30 53
29 52 42 26 38 24 34 53
