38 9 47 31 21 18 5 29
38 2 49 55 32 54 23 1
38 42 11 10 8 45 46 43
38 28 57 4 48 37 12 33
38 13 44 39 14 56 51 26
38 6 36 40 15 53 19 25
38 16 34 22 20 17 3 35
30 9 34 40 14 37 46 1
30 2 47 22 15 56 12 43
30 42 49 31 20 53 51 33
30 28 11 55 21 17 19 26
30 13 57 10 32 18 3 25
30 6 44 4 8 54 5 35
30 16 36 39 48 45 23 29
41 9 36 4 32 17 51 43
41 2 34 39 8 18 19 33
41 42 47 40 48 54 3 26
41 28 49 22 14 45 5 25
41 13 11 31 15 37 23 35
41 6 57 55 20 56 46 29
41 16 44 10 21 53 12 1
7 9 44 55 15 45 3 33
7 2 36 10 20 37 5 26
7 42 34 4 21 56 23 25
7 28 47 39 32 53 46 35
7 13 49 40 8 17 12 29
7 6 11 22 48 18 51 1
7 16 57 31 14 54 19 43
50 9 57 22 8 53 23 26
50 2 44 31 48 17 46 25
50 42 36 55 14 18 12 35
50 28 34 10 15 54 51 29
50 13 47 4 20 45 19 1
50 6 49 39 21 37 3 43
50 16 11 40 32 56 5 33
24 9 11 39 20 54 12 25
24 2 57 40 21 45 51 35
24 42 44 22 32 37 19 29
24 28 36 31 8 56 3 1
24 13 34 55 48 53 5 43
24 6 47 10 14 17 23 33
24 16 49 4 15 18 46 26
52 9 49 10 48 56 19 35
52 2 11 4 14 53 3 29
52 42 57 39 15 17 5 1
52 28 44 40 20 18 23 43
52 13 36 22 21 54 46 33
52 6 34 31 32 45 12 26
52 16 47 55 8 37 51 25
38 30 41 7 50 24 52 27
9 2 42 28 13 6 16 27
47 49 11 57 44 36 34 27
31 10 39 22 55 4 40 27
21 48 20 8 15 32 14 27
18 56 54 53 45 17 37 27
5 19 12 23 3 51 46 27
29 35 25 26 33 43 1 27
