19 126 80 41 4 82 35 9 117 102 114 13
19 59 30 51 129 15 88 91 125 128 93 109
19 20 73 81 95 124 77 24 17 76 104 31
19 67 34 28 122 27 70 2 108 57 119 40
19 103 43 101 61 3 110 54 52 22 90 10
19 56 21 72 11 107 47 12 36 112 71 92
19 16 38 53 1 25 130 14 74 42 45 60
19 106 48 44 33 116 85 58 132 68 39 99
19 5 133 29 113 100 96 79 94 49 118 63
19 6 78 86 89 8 87 115 84 98 23 69
19 127 75 111 26 46 7 62 64 50 131 18
32 126 75 86 113 116 130 12 52 57 104 109
32 59 80 111 89 100 85 14 36 22 119 31
32 20 30 41 26 8 96 58 74 112 90 40
32 67 73 51 4 46 87 79 132 42 71 10
32 103 34 81 129 82 7 115 94 68 45 92
32 56 43 28 95 15 35 62 84 49 39 60
32 16 21 101 122 124 88 9 64 98 118 99
32 106 38 72 61 27 77 91 117 50 23 63
32 5 48 53 11 3 70 24 125 102 131 69
32 6 133 44 1 107 110 2 17 128 114 18
32 127 78 29 33 25 47 54 108 76 93 13
55 126 78 44 11 27 88 62 94 42 90 31
55 59 75 29 1 3 77 9 84 68 71 40
55 20 80 86 33 107 70 91 64 49 45 10
55 67 30 111 113 25 110 24 117 98 39 92
55 103 73 41 89 116 47 2 125 50 118 60
55 56 34 51 26 100 130 54 17 102 23 99
55 16 43 81 4 8 85 12 108 128 131 63
55 106 21 28 129 46 96 14 52 76 114 69
55 5 38 101 95 82 87 58 36 57 93 18
55 6 48 72 122 15 7 79 74 22 104 13
55 127 133 53 61 124 35 115 132 112 119 109
83 126 133 72 95 46 85 54 125 98 45 40
83 59 78 53 122 82 96 12 17 50 39 10
83 20 75 44 61 15 87 14 108 102 118 92
83 67 80 29 11 124 7 58 52 128 23 60
83 103 30 86 1 27 35 79 36 76 131 99
83 56 73 111 33 3 88 115 74 57 114 63
83 16 34 41 113 107 77 62 132 22 93 69
83 106 43 51 89 25 70 9 94 112 104 18
83 5 21 81 26 116 110 91 84 42 119 13
83 6 38 28 4 100 47 24 64 68 90 109
83 127 48 101 129 8 130 2 117 49 71 31
105 126 48 28 26 25 77 115 36 128 118 10
105 59 133 101 4 116 70 62 74 76 23 92
105 20 78 72 129 100 110 9 132 57 131 60
105 67 75 53 95 8 47 91 94 22 114 99
105 103 80 44 122 46 130 24 84 112 93 63
105 56 30 29 61 82 85 2 64 42 104 69
105 16 73 86 11 15 96 54 117 68 119 18
105 106 34 111 1 124 87 12 125 49 90 13
105 5 43 41 33 27 7 14 17 98 71 109
105 6 21 51 113 3 35 58 108 50 45 31
105 127 38 81 89 107 88 79 52 102 39 40
37 126 38 51 33 124 96 2 84 22 131 92
37 59 48 81 113 27 87 54 64 112 114 60
37 20 133 28 89 3 7 12 117 42 93 99
37 67 78 101 26 107 35 14 125 68 104 63
37 103 75 72 4 25 88 58 17 49 119 69
37 56 80 53 129 116 77 79 108 98 90 18
37 16 30 44 95 100 70 115 52 50 71 13
37 106 73 29 122 8 110 62 36 102 45 109
37 5 34 86 61 46 47 9 74 128 39 31
37 6 43 111 11 82 130 91 132 76 118 40
37 127 21 41 1 15 85 24 94 57 23 10
121 126 21 111 61 8 70 79 17 68 93 60
121 59 38 41 11 46 110 115 108 49 104 99
121 20 48 51 1 82 47 62 52 98 119 63
121 67 133 81 33 15 130 9 36 50 90 69
121 103 78 28 113 124 85 91 74 102 71 18
121 56 75 101 89 27 96 24 132 128 45 13
121 16 80 72 26 3 87 2 94 76 39 109
121 106 30 53 4 107 7 54 84 57 118 31
121 5 73 44 129 25 35 12 64 22 23 40
121 6 34 29 95 116 88 14 117 112 131 10
121 127 43 86 122 100 77 58 125 42 114 92
66 126 43 29 129 107 87 24 74 50 119 99
66 59 21 86 95 25 7 2 132 102 90 63
66 20 38 111 122 116 35 54 94 128 71 69
66 67 48 41 61 100 88 12 84 76 45 18
66 103 133 51 11 8 77 14 64 57 39 13
66 56 78 81 1 46 70 58 117 22 118 109
66 16 75 28 33 82 110 79 125 112 23 31
66 106 80 101 113 15 47 115 17 42 131 40
66 5 30 72 89 124 130 62 108 68 114 10
66 6 73 53 26 27 85 9 52 49 93 92
66 127 34 44 4 3 96 91 36 98 104 60
120 126 34 53 89 15 110 58 64 76 71 63
120 59 43 44 26 124 47 79 117 57 45 69
120 20 21 29 4 27 130 115 125 22 39 18
120 67 38 86 129 3 85 62 17 112 118 13
120 103 48 111 95 107 96 9 108 42 23 109
120 56 133 41 122 25 87 91 52 68 131 31
120 16 78 51 61 116 7 24 36 49 114 40
120 106 75 81 11 100 35 2 74 98 93 10
120 5 80 28 1 8 88 54 132 50 104 92
120 6 30 101 33 46 77 12 94 102 119 60
120 127 73 72 113 82 70 14 84 128 90 99
65 126 73 101 1 100 7 91 108 112 39 69
65 59 34 72 33 8 35 24 52 42 118 18
65 20 43 53 113 46 88 2 36 68 23 13
65 67 21 44 89 82 77 54 74 49 131 109
65 103 38 29 26 15 70 12 132 98 114 31
65 56 48 86 4 124 110 14 94 50 93 40
65 16 133 111 129 27 47 58 84 102 104 10
65 106 78 41 95 3 130 79 64 128 119 92
65 5 75 51 122 107 85 115 117 76 90 60
65 6 80 81 61 25 96 62 125 57 71 99
65 127 30 28 11 116 87 9 17 22 45 63
123 126 30 81 122 3 47 14 132 49 23 18
123 59 73 28 61 107 130 58 94 98 131 13
123 20 34 101 11 25 85 79 84 50 114 109
123 67 43 72 1 116 96 115 64 102 93 31
123 103 21 53 33 100 87 62 117 128 104 40
123 56 38 44 113 8 7 9 125 76 119 10
123 16 48 29 89 46 35 91 17 57 90 92
123 106 133 86 26 82 88 24 108 22 71 60
123 5 78 111 4 15 77 2 52 112 45 99
123 6 75 41 129 124 70 54 36 42 39 63
123 127 80 51 95 27 110 12 74 68 118 69
19 32 55 83 105 37 121 66 120 65 123 97
126 59 20 67 103 56 16 106 5 6 127 97
80 30 73 34 43 21 38 48 133 78 75 97
41 81 101 53 29 111 51 28 72 44 86 97
4 122 1 89 129 61 33 26 95 11 113 97
82 3 100 15 107 8 124 25 46 27 116 97
35 47 7 110 87 70 96 77 85 88 130 97
9 14 91 58 24 79 2 115 54 62 12 97
117 132 108 64 74 17 84 36 125 94 52 97
102 49 112 76 50 68 22 128 98 42 57 97
114 23 39 71 119 93 131 118 45 90 104 97
13 18 69 63 99 60 92 10 40 31 109 97
