22 44 30 1 42 57 16 3
22 31 35 10 49 38 20 27
22 6 2 54 14 56 53 51
22 5 55 52 19 33 34 37
22 21 28 41 43 36 50 47
22 9 23 7 26 13 18 40
22 25 48 46 39 11 32 29
24 44 48 7 43 33 53 27
24 31 30 46 26 36 34 51
24 6 35 1 39 13 50 37
24 5 2 10 42 11 18 47
24 21 55 54 49 57 32 40
24 9 28 52 14 38 16 29
24 25 23 41 19 56 20 3
12 44 23 52 49 11 50 51
12 31 48 41 14 57 18 37
12 6 30 7 19 38 32 47
12 5 35 46 43 56 16 40
12 21 2 1 26 33 20 29
12 9 55 10 39 36 53 3
12 25 28 54 42 13 34 27
45 44 28 10 26 56 32 37
45 31 23 54 39 33 16 47
45 6 48 52 42 36 20 40
45 5 30 41 49 13 53 29
45 21 35 7 14 11 34 3
45 9 2 46 19 57 50 27
45 25 55 1 43 38 18 51
8 44 55 46 14 13 20 47
8 31 28 1 19 11 53 40
8 6 23 10 43 57 34 29
8 5 48 54 26 38 50 3
8 21 30 52 39 56 18 27
8 9 35 41 42 33 32 51
8 25 2 7 49 36 16 37
17 44 2 41 39 38 34 40
17 31 55 7 42 56 50 29
17 6 28 46 49 33 18 3
17 5 23 1 14 36 32 27
17 21 48 10 19 13 16 51
17 9 30 54 43 11 20 37
17 25 35 52 26 57 53 47
15 44 35 54 19 36 18 29
15 31 2 52 43 13 32 3
15 6 55 41 26 11 16 27
15 5 28 7 39 57 20 51
15 21 23 46 42 38 53 37
15 9 48 1 49 56 34 47
15 25 30 10 14 33 50 40
22 24 12 45 8 17 15 4
44 31 6 5 21 9 25 4
30 35 2 55 28 23 48 4
1 54 41 46 10 52 7 4
42 19 39 14 26 49 43 4
57 36 38 13 56 11 33 4
16 18 34 20 32 50 53 4
3 29 40 47 37 51 27 4
